돼지고기/소고기	밀봉하여 보관하고, 장기간 보관할 경우 소분하여 냉동보관해주세요	뼈와 비계부위는 일반쓰레기로, 살코기는 음식쓰레기로 배출해주세요.	구매일로부터 냉장보관시 2일, 냉동보관시 1년 이내에 섭취해 주세요. (개봉 즉시 섭취 권장)
닭고기	밀봉하여 보관하고, 장기간 보관할 경우 소분하여 냉동보관해주세요	뼈와 비계부위는 일반쓰레기로, 살코기는 음식쓰레기로 배출해주세요.	구매일로부터 냉장보관시 3일, 냉동보관시 2개월 이내에 섭취해 주세요.
콩고기	밀봉하여 냉동보관 해주세요.	음식물 쓰레기로 배출해주세요.	제조일로부터 12개월 이내에 섭취해 주세요.
포도	세척한 후, 밀폐용기에 보관 해주세요. 씻지 않은 과일과의 구분이 중요합니다.	음식물 쓰레기로 배출해주세요.	구매일로부터 냉장보관시 3~5일 이내에 섭취해 주십시오
딸기	세척한 후, 밀폐용기에 보관 해주세요. 씻지 않은 과일과의 구분이 중요합니다.	음식물 쓰레기로 배출해주세요.	구매일로부터 냉장보관시 3~5일 이내에 섭취해 주십시오
배	세척한 후, 밀폐용기에 보관 해주세요. 씻지 않은 과일과의 구분이 중요합니다.	음식물 쓰레기로 배출해주세요.	구매일로부터 냉장보관시 3주이내에 섭취해 주세요.
귤	귤끼리 닿지않고 통풍이 잘 되도록 키친타올로 감싸 냉장보관 해주세요. 베이킹파우더로 세척후 잘 말려 냉장보관하면 더욱 오래먹을 수 있습니다.	음식물 쓰레기로 배출해주세요.	구매일로부터 냉장보관시 3주이내에 섭취해 주세요.
사과	세척한 후, 밀폐용기에 보관 해주세요. 씻지 않은 과일과의 구분이 중요합니다.	음식물 쓰레기로 배출해주세요.	구매일로부터 냉장보관시 3주이내에 섭취해 주세요.
복숭아	세척한 후, 밀폐용기에 보관 해주세요. 씻지 않은 과일과의 구분이 중요합니다.	과육은 음식물 쓰레기로, 씨는 일반쓰레기로 배출해주세요.	구매일로부터 냉장보관시 3~5일 이내에 섭취해 주세요.
바나나	오래 보관할 경우, 양끝의 꼭지를 잘라 밀봉하여 냉장 보관해주세요.	음식물 쓰레기로 배출해주세요.	구매일로부터 상온 보관시 7~10일 이내에 섭취해주세요.
수박	베이킹소다로 세척한 후 잘라 주시고, 잘랐을 경우 과육을 분리하고 밀폐용기에 담아 냉장보관 해주세요.	과육은 음식물 쓰레기로, 껍질은 작게 잘라 음식물 쓰레기로 배출해주세요.	구매일로부터 실온 보관시 2~3일 이내, 냉장보관 시 5일 이내에 섭취해 주세요.(커팅된 제품이라면 냉장보관 시에도 2~3일 이내에 섭취권장)
브로콜리	세척한 후, 밀폐용기에 보관 해주세요. 씻지 않은 채소와의 구분이 중요합니다.	음식물 쓰레기로 배출해주세요.	냉동 보관시 구매일로부터 12개월 이내에 섭취해주세요.
호박	세척한 후, 밀폐용기에 보관 해주세요. 씻지 않은 채소와의 구분이 중요합니다.	과육은 음식물 쓰레기로, 껍질은 작게 잘라 음식물 쓰레기로 배출해주세요. 	애호박은 냉장보관시 구매일로부터 4~7일, 단호박은 소비기한이 없으나 자른 경우 냉장보관시 일주일 이내에 섭취해주세요.
토마토	공기가 잘 통하는 서늘한 곳에 실온 보관 해주세요 	음식물 쓰레기로 배출해주세요.	구매일로부터 상온 보관시 7~10일 이내에 섭취해주세요.
양파	공기순환이 잘 되는 그물망 같은 곳에 담아 서늘한 곳에 실온보관 해주세요. 감자와 같이 두는것은 피하시는게 좋습니다. 	알맹이는 음식물 쓰레기로, 껍질은 일반쓰레기로 배출해주세요.	구매일로부터 냉장보관시 7일 이내에 섭취해주세요.
가지	세척한 후, 밀폐용기에 보관 해주세요. 씻지 않은 채소와의 구분이 중요합니다.	음식물 쓰레기로 배출해주세요.	구매일로부터 냉장보관시 5일 이내에 섭취해주세요.
피망	세척한 후, 밀폐용기에 보관 해주세요. 씻지 않은 채소와의 구분이 중요합니다.	음식물 쓰레기로 배출해주세요.	구매일로부터 냉장보관시 5일 이내에 섭취해주세요.
당근	세척한 후, 밀폐용기에 보관 해주세요. 씻지 않은 채소와의 구분이 중요합니다.	음식물 쓰레기로 배출해주세요.	구매일로부터 냉장보관시 2주이내에 섭취해주세요.
파	세척한 후, 밀폐용기에 보관 해주세요. 씻지 않은 채소와의 구분이 중요합니다.	음식물 쓰레기로 배출해주세요.	구매일로부터 냉장보관시 10일, 냉동보관시 1개월 이내에 섭취해 주세요
무	세척한 후, 밀폐용기에 보관 해주세요. 씻지 않은 채소와의 구분이 중요합니다.	작게 잘라 음식물 쓰레기로 배출해주세요.	구매일로부터 냉장보관시 7일 이내에 섭취해주세요
버섯	냉장 보관시, 익히지 않은 상태로 키친타올에 감싸 보관해주세요. 냉동 보관시, 밑동을 손질하여 키친타올로 감싸 밀봉하여 보관해주세요. 	음식물 쓰레기로 배출해주세요.	구매일로부터 냉장보관시 5일 이내에 섭취해주세요
고구마	잘 말린 후, 상자에 담아 통풍이 잘 되는 서늘한 곳에 실온 보관해주세요. 빛을 차단하는 것이 중요합니다.	음식물 쓰레기로 배출해주세요.	구매일로부터 냉장보관시 7일 이내에 섭취해주세요
감자	종이봉투나 상자에 담아 서늘한 곳에 실온 보관해주세요.	음식물 쓰레기로 배출해주세요.	구매일로부터 냉장보관시 4~5일 이내에 섭취해주세요.
옥수수	구매 후 최대한 빨리 쪄서 냉동보관 해주세요.	껍질과 뿌리등 딱딱한 부분이 있을 경우 일반쓰레기로 배출해주세요.	구매일로부터 냉장보관시 7일 이내에 섭취해주세요.
생선(물고기)	씻어서 물기를 제거하고 지퍼백에 밀봉해주세요.	살코기는 음식물 쓰레기로,내장과 뼈는 일반쓰레기로 배출해주세요.	구매일로부터 냉동보관시 3개월 이내에 섭취해주세요
조개	해감하여 냉동보관 해주세요.	껍질은 일반쓰레기로 배출해주세요.	구매일로부터 냉동보관 시 2~3개월 이내에 섭취해주세요.
미역	한 번에 먹을만큼 소분하고 키친타올에 감싸 밀봉하여 보관해주세요.	음식물 쓰레기로 배출해주세요.	구매일로부터 1년 6개월 이내에 섭취해주세요.
새우	손질한 후 밀봉하여 냉장 혹은 냉동보관해주세요.	껍질은 일반쓰레기로, 살코기는 음식물 쓰레기로 배출해주세요.	구매일로부터 냉동보관시 3~6개월 이내에 섭취해주세요.
문어	생물은 씻어 냉동보관 하시고, 삶았을 경우 7일까지는 냉장보관 이후에는 냉동보관 해주세요.	음식물 쓰레기로 배출해주세요.	구매일로부터 냉동보관시 3~6개월 이내에 섭취해주세요.
쌀	서늘하고 통풍이 잘 되는 곳에 보관해주세요.	음식물 쓰레기로 배출해주세요.	제조일로부터 12개월 이내에 섭취해 주세요.
땅콩	서늘하고 통풍이 잘 되는 곳에 보관해주세요.	알맹이는 음식물 쓰레기로, 껍질은 일반쓰레기로 배출해주세요.	-
밤	-	알맹이는 음식물 쓰레기로, 껍질은 일반쓰레기로 배출해주세요.	견과류는 냉동보관을 하면 최대 4년까지 보관이 가능합니다.
아몬드	-	음식물 쓰레기로 배출해주세요.	견과류는 냉동보관을 하면 최대 4년까지 보관이 가능합니다.
요거트	냉장보관 해주세요.	음식물 쓰레기로 배출해주세요.	유통기한 경과 후 10일 이내에 섭취해주세요.(미개봉, 냉동보관 기준)
치즈	냉장보관 해주세요.	음식물 쓰레기로 배출해주세요.	가공치즈는 유통기한 경과 후 70일 이내에 섭취해주세요. (냉장, 밀봉 보관 기준)
우유	냉장보관 해주세요.	-	개봉했을 경우 최대 일주일, 미개봉시 제주일부터 최대 50일 이내에 섭취해 주세요(냉장보관 기준)
두유	-	-	유통기한 경과 후 90일 이내에 섭취해주세요. (개봉시에는 아주 쉽게 상하니 바로 다 드시길 바랍니다)
버터	냉장보관 해주세요.	일반쓰레기로 배출해주세요.	유통기한 경과 후 14일 이내에 섭취해주세요.(미개봉, 냉장보관 기준)
달걀	뚜껑이 있는 포장용기 그대로 냉장고 안쪽에 보관해주세요.	껍질을 포함할 경우 일반쓰레기로 배출해 주세요.	유통기한 경과 후 25일 이내에 섭취해주세요. (냉장보관 기준/기한을 엄수해주세요)
라면사리	서늘한 곳에 보관해주세요.	일반쓰레기로 배출해주세요.	유통기한 경과 후 50일 이내에 섭취해주세요. (서늘한 곳에 보관 기준)
일반면	서늘한 곳에 보관해주세요.	일반쓰레기로 배출해주세요.	유통기한 경과 후 8개월 이내에 섭취해주세요. (서늘한 곳에 보관 기준)
스파게티면	서늘한 곳에 보관해주세요.	일반쓰레기로 배출해주세요.	유통기한 경과 후 1년 이내에 섭취해주세요.(서늘한 곳에 보관 기준)
마요네즈	실온보관 해주세요. (냉장보관 할 경우 밀봉하여 거꾸로 세워 보관해주세요)	일반쓰레기로 배출해주세요.	유통기한 경과 후 90일 이내에 섭취해주세요.(냉장보관 기준)
케챱	냉장보관 해주세요.	일반쓰레기로 배출해주세요.	유통기한 경과 후 90일 이내에 섭취해 주세요.(냉장보관 기준)
올리브유(식용유)	서늘한 곳에서 보관해주세요.	-	유통기한 경과 후 5년 이내에 섭취해 주세요(미개봉, 서늘한 곳에 보관 기준)
밀가루	냉동보관 해주세요.	음식물 쓰레기로 배출해주세요.	유통기한 경과 후 2년 이내에 섭취해 주세요(미개봉, 서늘한 곳에 보관 기준)
설탕	냉장보관 해주세요.	일반쓰레기로 배출해주세요.	-
소금	냉장보관 해주세요.	일반쓰레기로 배출해주세요.	-
간장	냉장보관 해주세요.	-	유통기한 경과 후 2년 이내에 섭취해주세요(미개봉,냉장 보관 기준)
잼	냉장보관 해주세요.	일반쓰레기로 배출해주세요.	유통기한 경과 후 1년 이내에 섭취해주세요(미개봉, 냉장보관 기준)
통조림	서늘한 곳에 보관해주세요.	내용물은 음식물쓰레기로 배출해주세요.	유통기한 경과 후 미개봉시 10년 이내에 섭취해주세요.(직사광선을 피하고 캔이 찌그러지거나 녹슬지 않게 보관하면 오래 섭취가 가능합니다.)
냉동식품	냉동고에 보관해주세요.	음식물 쓰레기로 배출해주세요.	유통기한 경과 후 1년 이내에 섭취해주세요(미개봉, 냉동보관)
간편조리식품	서늘한 곳에 보관해주세요.	음식물 쓰레기로 배출해주세요.	유통기한 경과 후 1년 이내에 섭취해주세요(미개봉, 냉동보관)
가열조리식품	냉동고 상단에 보관해주세요.	음식물 쓰레기로 배출해주세요.	조리 후 즉시 섭취하기실 바랍니다.
건강식품	서늘한 곳에 보관해주세요.	약국과 보건소에 비치된 폐의약품 수거함에 넣어주세요.	-
음료/제과류	-	음식물 쓰레기로 배출해주세요.	구매일로부터 냉장보관시 2주 이내에 섭취해 주십시오
			-
